1111111111
1000000001
1000000E01
1000000001
100C010001
1000010001
1000010011
100P010001
1000000001
1111111111
