11111111111111111111
1C00000C1CC0000000C1
101100111CC111001101
10000000000000000001511
101100111CC111001101
10000010000000000001
100C10001PE10001C001
10000000000001000001
101100111CC111001101
10000000000000000001
101100111CC111001101
1C0000000CC1C00000C1
11111111111111111111
