11111111111111111111
1C0000000C00000000P1
10000000000000000C01
10011111101111111001
1001C0000000000C1001
10010000000000001001
10010011110111001001
1C00001EC000C10000C1
1001001CC000C1001001
10010011101111001001
10010000000000001001
1001C0000000000C1001
10011111101111111001
10C00000000000000001
100000000C00000000C1
11111111111111111111
