1111111111111111111111111111111
1000000000000000000000000000001
100CCCCC100011111110001CCCCC001
100CCCCC10001CCCCC10001CCCCC001
1001111110001CC1CC1000111111001
1000000000001CCCCC1000000000001
1001111110001100011000111111001
100CCCCC100000000000001CCCCC001
100CCCCC1000000P0000001CCCCC001
100000000000110E011000000000001
1111111111111111111111111111111
