11111111111111111111
1C000000CX0C000000C1
10110011CCCC11001101
10000000000000000001
101100111C0111001101
10000000000000000001
100C100011110001C001
10000000000000000001
1011001100C011001101
10000000000000000001
1011001110C111001101
1C0000000PE0000000C1
11111111111111111111
