1111111111
1000X000P1
1C0CEC00C1
1000000001
1111111111
