1111111111
1CCCCCCEP1
1C111111C1
1CCCCCCCC1
1111111111
